Enigma - Sadeness
ESPRIT 空想 - cry 
Fatboy Slim - Right Here, Right Now
GSPD - Героиновый шик
GSPD - КТО СКАЗАЛ МЯУ?
Haddaway - What Is Love 
Hainbach - They Can Feel You
Hatsune Miku - Bad Apple!!
IVAN - My Heart
Janji feat. Johnning - Heroes Tonight
Lumi Athena ft. jnhygs - SMOKE IT OFF!
MATRANG - Медуза
Memphis Cult - 9MM
Modjo - Lady
moUsebit - Evil Boss
MoonDeity - NEON BLADE
MUR - Klub Brooklyn
muzzle - Мне 13
Myuu - Final Boss
NBSPLV - The Lost Soul Down
Nedaj - Alone
nihigo - angelic
nosgov - goes nowhere
Princess Chelsea - The Cigarette Duet
Professor Kliq - Desert Sun
Public Enemy - Rebel Without A Pause
QsensX - Pt. 15
Rob Base & DJ EZ Rock - It Takes Two
SOSKA 69 - БАСЫ ДОЛБЯТ
Zombie Nation - Kernkraft 400
Агата Кристи - Как на войне
Андрей Губин - Ночь (reverb & underwater)
вышел покурить - сопротивление